Anchorage	Alaska
Phoenix	Arizona
Tucson	Arizona
Bakersfield	California
Fresno	California
Long Beach	California
Los Angeles	California
Oakland	California
Sacramento	California
San Diego	California
San Francisco	California
San Jose	California
Santa Barbara	California
Colorado Springs	Colorado
Denver	Colorado
Washington DC	District of Columbia
Fort Lauderdale	Florida
Jacksonville	Florida
Miami	Florida
Orlando	Florida
Petersburg	Florida
Sarasota	Florida
Tampa	Florida
Atlanta	Georgia
Savannah	Georgia
Honolulu	Hawaii
Boise	Idaho
Chicago	Illinois
Indianapolis	Indiana
Des Moines	Iowa
Wichita	Kansas
Louisville	Kentucky
Baton Rouge	Louisiana
New Orleans	Louisiana
Baltimore	Maryland
Boston	Massachusetts
Detroit	Michigan
Grand Rapids	Michigan
Minneapolis	Minnesota
Kansas City	Missouri
Omaha	Nebraska
Las Vegas	Nevada
Albuquerque	New Mexico
Buffalo	New York
New York	New York
Rochester	New York
Charlotte	North Carolina
Raleigh	North Carolina
Wilmington	North Carolina
Cincinnati	Ohio
Cleveland	Ohio
Columbus	Ohio
Oklahoma City	Oklahoma
Tulsa	Oklahoma
Portland	Oregon
Philadelphia	Pennsylvania
Pittsburgh	Pennsylvania
Providence	Rhode Island
Charleston	South Carolina
Greenville	South Carolina
Myrtle Beach	South Carolina
Chattanooga	Tennessee
Knoxville	Tennessee
Memphis	Tennessee
Nashville	Tennessee
Austin	Texas
Dallas	Texas
El Paso	Texas
Houston	Texas
San Antonio	Texas
Salt Lake City	Utah
Alexandria	Virginia
Richmond	Virginia
Seattle	Washington
Spokane	Washington
Madison	Wisconsin
Milwaukee	Wisconsin